1111111
1000001
1042401
1024201
1042401
1024201
1005001
1111111

