1111111111111111
1000000000000001
1010111111000001
1010020202021001
10100025200011011
10100202021114441
10100020200114441
10111222020114441
10000010110114441
11111000110114441
00001111100000111
000000001000001
000000001111111
