1111111
1050001
100001
1020001
1004001
1000001
1111111
