1111111
1050001
1000201
1000201
1030001
1000441
1111111
